SO ./assets/wall2.xpm
NO ./assets/wall1.xpm
EA ./assets/wall4.xpm
WE ./assets/wall3.xpm

C 108,137,166
F 39,46,39

    11111111111111111111111111
111110000000000000000000000001
100011010011000001000000000001
110000000001000000100000000001
110011011011000000000000000001
100000000011000001110110110111
101101100001010100000000100101
100000000000011101010100000001
10000010100001 100001010000001
100000000000011101000100000001
100W00000000000001010000000001
110000011101010101001001000001
11110111 111010000000000000001
11111111 111111111111111111111