NO ./assets/wall1.xpm
SO ./assets/wall2.xpm
WE ./assets/wall3.xpm
EA ./assets/wall4.xpm

F 220,100,0
C 225,30,0

111111111111111111111111111111
1N1000001000000000110000000001
111000000011000001110000000001
100000001001000000000000000001
111000011011000001110000000001
100000000011000001110111111111
11110111111111011100000010001
11110111110001011101010000001
11000000110101011100000010001
10000000000000001100000010001
10000000000000001101010010001
11000001110101011100111110001
11110111 11101000000011010001
11111111 11111111111111111111