NO ./assets/wall1.xpm
SO ./assets/wall2.xpm
WE ./assets/wall3.xpm
EA ./assets/wall4.xpm

C 108,137,166
F 39,46,39

        1111111111111111111111
    11111000000000110000000001
    10000011000001110000000001
    11111001000000000000000001
111111111011000001000000000001
100000000011000001110110110111
111101111111110100000000100101
111101111100010101010100000001
110000001101010101000000100001
100000000000000000000000100001
1000N0000000000001010100000001
110000011101010101001001000001
11110111 111010000000000000001
11111111 111111111111111111111
