NO ./assets/wall1.xpm
SO ./assets/wall2.xpm
WE ./assets/wall3.xpm
EA ./assets/wall4.xpm

C 108,137,166
F 39,46,39

        1111111111111111111111
    11111000000000110000000001
    10000011000001110000000001
    11111001000000000000000001
111111111011000001110000000001
100000000011000001110111110111
111101111111110111000000100101
111101111100010111010100000001
110000001101010111000000100001
100000000000000011000000100001
100000000000000011010100000001
11000001110101011100110110N001
11110111 111010000000000000001
11111111 111111111111111111111
