NO ./assets/wall1.xpm
SO ./assets/wall2.xpm
WE ./assets/wall3.xpm
EA ./assets/wall4.xpm

F 220,100,0
C 225,30,0

        1111111111111111111111111
        1000000000110000000000001
        1011000001110001110000001
        100100000000000111000000111
11111111101100000111000000000000001
10000000000100000111011111111111101
11110111110111011100000010001   101
11110111110111011101010010001111101
11000000110101011100011111100010001
10000000000000001100011111100000001
10000100000000001100000010001111111
1001111111111110000011000000100001
1000001       1100011000000100010111
1000001       11000110000001000001
1000001       11000110000001000111
1000001       110001100000010001
1000001       110001100000010001
10000111111111100011010100100011
11000001110000001111000010N0111
11110111 10101011  1111010001
11110111110111111111111010111
  1100000000000000000000001
   111111111111111111111111