NO ./assets/wall1.xpm
SO ./assets/wall2.xpm
WE ./assets/wall3.xpm
EA ./assets/wall4.xpm

F 220,100,0
C 225,30,0

111111111111111111111111111111111111111111111
100000000000000000000000000000000000000000001
101111111111111111111011111111111111111111101
101                 101                   101
101 1111111111111111101111111111111111111 101
101 1000000000000000000000000000000000001 101
101 1011111111111101111111101111111111101 101
1011101          101      101         1011101
1000001          101      101         1000001
1011101          101      101         1011101
101 1011111111111101111111101111111111101 101
101 1000000000000000000000000000000000001 101
101 1111111111111111110111111111111111111 101
101                  101                  101
101111111111111111111101111111111111111111101
1000000000000000000000W0000000000000000000001
111111111111111111111111111111111111111111111