NO ./assets/wall1.xpm
SO ./assets/wall2.xpm
WE ./assets/wall3.xpm
EA ./assets/wall4.xpm

C 108,137,166
F 39,46,39

111111
100101
101001
1100N1
111111